             \n
       AI    \n
   0123456789\n
  A~~~~~~~~~~\n
  B~~~~~~~~~~\n
  C~~~~~~~~~~\n
  D~~~~~~~~~~\n
  E~~~~~~~~~~\n
  F~~~~~~~~~~\n
  G~~~~~~~~~~\n
  H~~~~~~~~~~\n
  I~~~~~~~~~~\n
  J~~~~~~~~~~\n
             \n
   ||||||||||\n
             \n
   0123456789\n
  A~~~~~~~~~~\n
  B~~~~~~~~~~\n
  C~~~~~~~~~~\n
  D~~~~~~~~~~\n
  E~~~~~~~~~~\n
  F~~~~~~~~~~\n
  G~~~~~~~~~~\n
  H~~~~~~~~~~\n
  I~~~~~~~~~~\n
  J~~~~~~~~~~\n
     PLAYER  \n
